1,1,1,S,1,1,1,1
0,1,0,0,0,1,0,1
1,0,0,G,0,0,1,1
1,0,0,1,1,1,1,1
1,0,0,0,E,1,1,1
